#Map(TextureID),,,,,,,,,,
0x00,0x00,0x00,0x00,0x00,0x00,0x00,0x00,0x00,0x00,0x00
0x00,0x00,0x00,0x00,0x00,0x01,0x01,0x01,0x01,0x01,0x00
0x00,0x01,0x01,0x01,0x00,0x01,0x00,0x00,0x00,0x01,0x00
0x00,0x01,0x00,0x01,0x00,0x01,0x01,0x00,0x01,0x01,0x00
0x00,0x01,0x00,0x01,0x00,0x00,0x01,0x00,0x01,0x00,0x00
0x01,0x01,0x00,0x01,0x00,0x00,0x01,0x00,0x01,0x01,0x01
0x00,0x00,0x00,0x01,0x00,0x00,0x01,0x00,0x00,0x00,0x00
0x00,0x01,0x01,0x01,0x00,0x00,0x01,0x01,0x01,0x01,0x00
0x00,0x01,0x00,0x00,0x00,0x00,0x00,0x00,0x00,0x01,0x00
0x00,0x01,0x00,0x01,0x01,0x01,0x01,0x01,0x01,0x01,0x00
0x00,0x00,0x00,0x00,0x00,0x00,0x00,0x00,0x00,0x00,0x00
