#Map(canplace),#0:FALSE,#else:TRUE,,,,,,,,
1,1,1,1,1,1,1,1,1,1,1
1,1,1,1,1,0,0,0,0,0,1
1,0,0,0,1,0,1,1,1,0,1
1,0,1,0,1,0,0,1,0,0,1
1,0,1,0,1,1,0,1,0,1,1
0,0,1,0,1,1,0,1,0,0,0
1,1,1,0,1,1,0,1,1,1,1
1,0,0,0,1,1,0,0,0,0,1
1,0,1,1,1,1,1,1,1,0,1
1,0,0,0,0,0,0,0,0,0,1
1,1,1,1,1,1,1,1,1,1,1
